000000000000000000000000000000111111111111111111100000000000
111111111111111111100000000000000000000000000000000000111111
111111111111111111100000111111111111111111111111100000000000
111111111111111111100000000000000000000000000000000000111111
111111111111111111100000000000111111111111111111100000000000
111111111111111111100000111111000000000000000000000000111111
000000000000000000000000000000111111111111111111100000000000
011111111111111111110000000000000000000000000000000000111111
011111111111111111110000111111111111111111111111100000000000
011111111111111111110000000000000000000000000000000000111111
011111111111111111110000000000111111111111111111100000000000
011111111111111111110000111111000000000000000000000000111111
000000000000000000000000000000111111111111111111100000000000
000000000000000000000000000000000000000000000000000000111111
000000000000000000000000111111111111111111111111100000000000
000000000000000000000000000000000000000000000000000000111111
000000000000000000000000000000111111111111111111100000000000
111111111111111111100000000000000000000000000000000000111111
111111111111111111100000111111111111111111111111100000000000
111111111111111111100000000000000000000000000000000000111111
111111111111111111100000000000111111111111111111100000000000
111111111111111111100000111111000000000000000000000000111111
000000000000000000000000000000111111111111111111100000000000
011111111111111111110000000000000000000000000000000000111111
011111111111111111110000111111111111111111111111100000000000
011111111111111111110000000000000000000000000000000000111111
011111111111111111110000000000111111111111111111100000000000
011111111111111111110000111111000000000000000000000000111111
000000000000000000000000000000111111111111111111100000000000
000000000000000000000000000000000000000000000000000000111111
000000000000000000000000111111111111111111111111100000000000
000000000000000000000000000000000000000000000000000000111111